2020-01-12 00:00:00,510000,510100,610471,9,4,4,4,0,0,100.00,0,4,0.00,0,0.00
2020-01-12 00:00:00,310000,310100,201022,9,1,1,1,0,0,100.00,1,0,100.00,0,0.00
2020-01-12 00:00:00,310000,310100,201151,9,3,3,3,0,0,100.00,3,0,100.00,1,33.33
2020-01-12 00:00:00,510000,510100,610200,9,134,134,125,9,0,100.00,78,56,58.21,62,46.27
2020-01-12 00:00:00,310000,310100,200247,2,1,1,1,0,0,100.00,1,0,100.00,0,0.00
2020-01-12 00:00:00,310000,310100,201255,9,36,35,30,5,1,97.22,20,16,55.56,6,17.14
2020-01-12 00:00:00,310000,310100,201912,9,27,27,22,5,0,100.00,11,16,40.74,3,11.11
2020-01-12 00:00:00,310000,310100,200202,9,240,237,214,23,3,98.75,106,134,44.17,49,20.68
2020-01-12 00:00:00,510000,510100,610100,2,2,0,0,0,2,0.00,0,2,0.00,0,0.00
2020-01-12 00:00:00,310000,310100,200966,9,16,16,14,2,0,100.00,13,3,81.25,2,12.50
2020-01-12 00:00:00,310000,310100,202947,2,7,4,4,0,3,57.14,4,3,57.14,0,0.00
2020-01-12 00:00:00,310000,310100,201306,2,2,2,2,0,0,100.00,2,0,100.00,0,0.00
2020-01-13 00:00:00,310000,310100,201151,9,3,0,0,0,3,0.00,0,3,0.00,0,0.00
2020-01-11 00:00:00,310000,310100,201917,2,12,12,12,0,0,100.00,10,2,83.33,0,0.00
2020-01-12 00:00:00,310000,310100,200191,9,58,58,57,1,0,100.00,0,58,0.00,8,13.79
2020-01-13 00:00:00,510000,510100,610471,2,1,0,0,0,1,0.00,0,1,0.00,0,0.00
2020-01-11 00:00:00,310000,310100,201247,2,6,6,6,0,0,100.00,5,1,83.33,0,0.00
2020-01-12 00:00:00,510000,510100,610100,9,30,30,28,2,0,100.00,8,22,26.67,9,30.00
2020-01-13 00:00:00,310000,310100,202947,9,5,4,4,0,1,80.00,3,2,60.00,1,25.00
2020-01-11 00:00:00,510000,510100,610100,9,25,25,21,4,0,100.00,14,11,56.00,9,36.00
2020-01-12 00:00:00,310000,310100,201917,9,24,24,20,4,0,100.00,24,0,100.00,3,12.50
2020-01-13 00:00:00,310000,310100,200960,9,24,0,0,0,24,0.00,0,24,0.00,0,0.00
2020-01-11 00:00:00,310000,310100,200966,9,45,45,45,0,0,100.00,0,45,0.00,9,20.00
2020-01-12 00:00:00,310000,310100,201422,2,23,19,19,0,4,82.61,17,6,73.91,0,0.00
2020-01-13 00:00:00,310000,310100,200509,9,125,37,32,5,88,29.60,35,90,28.00,9,24.32
2020-01-11 00:00:00,310000,310100,202947,9,5,5,5,0,0,100.00,4,1,80.00,2,40.00
2020-01-12 00:00:00,310000,310100,202947,9,8,7,5,2,1,87.50,7,1,87.50,3,42.86
2020-01-13 00:00:00,310000,310100,200202,9,272,166,151,15,106,61.03,156,116,57.35,38,22.89
2020-01-11 00:00:00,310000,310100,300400,9,36,36,34,2,0,100.00,17,19,47.22,10,27.78
2020-01-12 00:00:00,310000,310100,201247,2,9,8,8,0,1,88.89,8,1,88.89,0,0.00
2020-01-13 00:00:00,310000,310100,200065,9,1,0,0,0,1,0.00,0,1,0.00,0,0.00
2020-01-11 00:00:00,310000,310100,201912,2,7,7,7,0,0,100.00,5,2,71.43,2,28.57
2020-01-12 00:00:00,310000,310100,201306,9,5,5,5,0,0,100.00,1,4,20.00,1,20.00
2020-01-13 00:00:00,310000,310100,201247,2,8,0,0,0,8,0.00,0,8,0.00,0,0.00
2020-01-11 00:00:00,510000,510100,610100,2,1,1,1,0,0,100.00,0,1,0.00,0,0.00
2020-01-12 00:00:00,510000,510100,610200,2,9,9,9,0,0,100.00,9,0,100.00,0,0.00
2020-01-13 00:00:00,310000,310100,201422,2,35,0,0,0,35,0.00,0,35,0.00,0,0.00
2020-01-11 00:00:00,310000,310100,200191,2,30,30,27,3,0,100.00,25,5,83.33,1,3.33
2020-01-12 00:00:00,310000,310100,300400,2,32,29,29,0,3,90.63,25,7,78.13,2,6.90
2020-01-13 00:00:00,310000,310100,201912,2,4,0,0,0,4,0.00,0,4,0.00,0,0.00
2020-01-11 00:00:00,310000,310100,201422,2,25,25,24,1,0,100.00,17,8,68.00,1,4.00
2020-01-12 00:00:00,310000,310100,201247,9,13,13,10,3,0,100.00,3,10,23.08,3,23.08
2020-01-13 00:00:00,310000,310100,200230,9,22,6,5,1,16,27.27,6,16,27.27,3,50.00
2020-01-11 00:00:00,310000,310100,200202,9,353,353,319,34,0,100.00,169,184,47.88,75,21.25
2020-01-12 00:00:00,310000,310100,200966,2,21,21,21,0,0,100.00,20,1,95.24,1,4.76
2020-01-13 00:00:00,310000,310100,202319,9,1,0,0,0,1,0.00,0,1,0.00,0,0.00
2020-01-11 00:00:00,310000,310100,200509,2,118,116,111,5,2,98.31,94,24,79.66,7,6.03
2020-01-12 00:00:00,310000,310100,201255,2,32,31,30,1,1,96.88,30,2,93.75,2,6.45
2020-01-13 00:00:00,310000,310100,300400,2,32,0,0,0,32,0.00,0,32,0.00,0,0.00
2020-01-11 00:00:00,310000,310100,200230,2,3,3,3,0,0,100.00,3,0,100.00,0,0.00
2020-01-12 00:00:00,310000,310100,200247,9,1,1,1,0,0,100.00,0,1,0.00,1,100.00
2020-01-13 00:00:00,310000,310100,202947,2,10,0,0,0,10,0.00,0,10,0.00,0,0.00
2020-01-11 00:00:00,310000,310100,200230,9,23,23,22,1,0,100.00,0,23,0.00,5,21.74
2020-01-12 00:00:00,310000,310100,200230,9,16,16,15,1,0,100.00,0,16,0.00,4,25.00
2020-01-13 00:00:00,510000,510100,610100,9,26,12,6,6,14,46.15,9,17,34.62,0,0.00
2020-01-11 00:00:00,310000,310100,201912,9,41,41,38,3,0,100.00,24,17,58.54,10,24.39
2020-01-12 00:00:00,310000,310100,200509,9,147,144,131,13,3,97.96,27,120,18.37,24,16.67
2020-01-13 00:00:00,310000,310100,201255,9,41,29,26,3,12,70.73,25,16,60.98,4,13.79
2020-01-11 00:00:00,310000,310100,202947,2,7,7,7,0,0,100.00,6,1,85.71,0,0.00
2020-01-12 00:00:00,310000,310100,200509,2,101,93,93,0,8,92.08,86,15,85.15,4,4.30
2020-01-13 00:00:00,310000,310100,201255,2,22,0,0,0,22,0.00,0,22,0.00,0,0.00
2020-01-11 00:00:00,510000,510100,610471,2,1,1,1,0,0,100.00,1,0,100.00,0,0.00
2020-01-12 00:00:00,310000,310100,200317,9,1,1,1,0,0,100.00,0,1,0.00,0,0.00
2020-01-13 00:00:00,310000,310100,200509,2,126,0,0,0,126,0.00,0,126,0.00,0,0.00
2020-01-11 00:00:00,310000,310100,201022,2,1,1,1,0,0,100.00,1,0,100.00,0,0.00
2020-01-12 00:00:00,310000,310100,200230,2,2,1,1,0,1,50.00,1,1,50.00,0,0.00
2020-01-13 00:00:00,310000,310100,201022,9,3,0,0,0,3,0.00,0,3,0.00,0,0.00
2020-01-11 00:00:00,310000,310100,200065,9,3,3,3,0,0,100.00,0,3,0.00,0,0.00
2020-01-12 00:00:00,310000,310100,201422,9,63,61,60,1,2,96.83,3,60,4.76,12,19.67
2020-01-13 00:00:00,310000,310100,201917,9,25,19,19,0,6,76.00,19,6,76.00,5,26.32
2020-01-11 00:00:00,510000,510100,610200,2,11,11,11,0,0,100.00,11,0,100.00,0,0.00
2020-01-12 00:00:00,310000,310100,201151,2,1,1,1,0,0,100.00,1,0,100.00,0,0.00
2020-01-13 00:00:00,510000,510100,610008,9,2,1,0,1,1,50.00,1,1,50.00,1,100.00
2020-01-11 00:00:00,310000,310100,201306,9,9,9,9,0,0,100.00,1,8,11.11,1,11.11
2020-01-12 00:00:00,310000,310100,200202,2,140,137,136,1,3,97.86,122,18,87.14,5,3.65
2020-01-13 00:00:00,310000,310100,201306,2,1,0,0,0,1,0.00,0,1,0.00,0,0.00
2020-01-11 00:00:00,310000,310100,200191,9,48,48,45,3,0,100.00,7,41,14.58,14,29.17
2020-01-12 00:00:00,310000,310100,201022,2,1,1,1,0,0,100.00,1,0,100.00,0,0.00
2020-01-13 00:00:00,310000,310100,300400,9,22,0,0,0,22,0.00,0,22,0.00,0,0.00
2020-01-11 00:00:00,310000,310100,201917,9,20,20,18,2,0,100.00,16,4,80.00,5,25.00
2020-01-12 00:00:00,510000,510100,610471,2,1,0,0,0,1,0.00,0,1,0.00,0,0.00
2020-01-13 00:00:00,310000,310100,200202,2,148,0,0,0,148,0.00,0,148,0.00,0,0.00
2020-01-11 00:00:00,310000,310100,201255,2,21,21,21,0,0,100.00,15,6,71.43,0,0.00
2020-01-12 00:00:00,310000,310100,200191,2,27,27,27,0,0,100.00,22,5,81.48,2,7.41
2020-01-13 00:00:00,310000,310100,200966,9,31,15,13,2,16,48.39,15,16,48.39,3,20.00
2020-01-11 00:00:00,310000,310100,300400,2,26,25,25,0,1,96.15,24,2,92.31,0,0.00
2020-01-12 00:00:00,310000,310100,201912,2,11,11,11,0,0,100.00,10,1,90.91,0,0.00
2020-01-13 00:00:00,310000,310100,201422,9,69,0,0,0,69,0.00,0,69,0.00,0,0.00
2020-01-11 00:00:00,310000,310100,200966,2,34,33,32,1,1,97.06,25,9,73.53,1,3.03
2020-01-12 00:00:00,310000,310100,201917,2,12,11,11,0,1,91.67,11,1,91.67,0,0.00
2020-01-13 00:00:00,310000,310100,200960,2,17,0,0,0,17,0.00,0,17,0.00,0,0.00
2020-01-11 00:00:00,510000,510100,610471,9,6,6,6,0,0,100.00,0,6,0.00,1,16.67
2020-01-12 00:00:00,310000,310100,300400,9,62,62,58,4,0,100.00,16,46,25.81,15,24.19
2020-01-13 00:00:00,310000,310100,200966,2,21,0,0,0,21,0.00,0,21,0.00,0,0.00
2020-01-11 00:00:00,510000,510100,610008,9,4,4,3,1,0,100.00,2,2,50.00,1,25.00
2020-01-13 00:00:00,310000,310100,201912,9,9,7,7,0,2,77.78,6,3,66.67,0,0.00
2020-01-11 00:00:00,310000,310100,200960,9,18,18,15,3,0,100.00,17,1,94.44,5,27.78
2020-01-13 00:00:00,510000,510100,610200,9,124,91,87,4,33,73.39,88,36,70.97,43,47.25
2020-01-11 00:00:00,510000,510100,610008,2,1,1,1,0,0,100.00,0,1,0.00,0,0.00
2020-01-13 00:00:00,310000,310100,200191,2,19,0,0,0,19,0.00,0,19,0.00,0,0.00
2020-01-11 00:00:00,310000,310100,201255,9,28,28,24,4,0,100.00,20,8,71.43,5,17.86
2020-01-13 00:00:00,510000,510100,610200,2,18,0,0,0,18,0.00,0,18,0.00,0,0.00
2020-01-11 00:00:00,310000,310100,200960,2,21,21,21,0,0,100.00,21,0,100.00,0,0.00
2020-01-13 00:00:00,310000,310100,201247,9,14,6,6,0,8,42.86,6,8,42.86,3,50.00
2020-01-11 00:00:00,310000,310100,200202,2,218,216,209,7,2,99.08,161,57,73.85,5,2.31
2020-01-13 00:00:00,310000,310100,201917,2,7,0,0,0,7,0.00,0,7,0.00,0,0.00
2020-01-11 00:00:00,310000,310100,201422,9,85,85,78,7,0,100.00,3,82,3.53,19,22.35
2020-01-13 00:00:00,310000,310100,200247,2,1,0,0,0,1,0.00,0,1,0.00,0,0.00
2020-01-11 00:00:00,310000,310100,201022,9,11,11,11,0,0,100.00,8,3,72.73,3,27.27
2020-01-13 00:00:00,310000,310100,200230,2,2,0,0,0,2,0.00,0,2,0.00,0,0.00
2020-01-11 00:00:00,310000,310100,201247,9,16,16,15,1,0,100.00,4,12,25.00,0,0.00
2020-01-13 00:00:00,310000,310100,200191,9,29,0,0,0,29,0.00,0,29,0.00,0,0.00
2020-01-11 00:00:00,310000,310100,200509,9,118,118,107,11,0,100.00,26,92,22.03,21,17.80
2020-01-13 00:00:00,510000,510100,610471,9,5,0,0,0,5,0.00,0,5,0.00,0,0.00
2020-01-11 00:00:00,510000,510100,610200,9,125,125,120,5,0,100.00,80,45,64.00,58,46.40